0#111111#0
0212222210
0110111010
0212222210
0#111111#0
