0001111000
0011111100
0111111110
0011111100
0001111000
