1010101010
0101010101
1111111111
0101010101
1010101010
