1110011110
1100000011
1001111001
1100000011
0111111110
