2011111102
0122222210
0111111110
00#00000#0
0011111100
