2001100112
0201111102
0022222200
0201111102
2001100112
