0011111100
0112222210
0111111110
0011111100
0001111000
