##########
02######20
0222222220
02######20
##########
